99 99 99 99 99 99 99 99 99 99 99 99 99
99 99 99 99 99 99 99 99 99 99 99 99 99
99 99 99 99 99 99 99 99 99 99 99 99 99
99 99 99 99 99 99 99 99 99 99 99 99 99
01 01 01 01 01 01 01 01 01 01 01 01 01
01 01 01 01 01 01 01 01 01 01 01 01 01
99 99 99 99 99 99 99 99 99 99 99 99 99
06 13 99 99 13 06 06 06 13 99 99 13 06
06 13 99 99 13 06 06 06 13 99 99 13 06
06 13 99 99 13 06 06 06 13 99 99 13 06
06 13 99 99 13 06 06 06 13 99 99 13 06
99 99 99 99 99 99 99 99 99 99 99 99 99
00 00 00 00 00 00 00 00 00 00 00 00 00
00 00 00 00 00 00 00 00 00 00 00 00 00
99 99 99 99 99 99 99 99 99 99 99 99 99
99 99 99 99 99 99 99 99 99 99 99 99 99
99 99 99 99 99 99 99 99 99 99 99 99 99
99 99 99 99 99 99 99 99 99 99 99 99 99
99 99 99 99 99 99 99 99 99 99 99 99 99
99 99 99 99 99 99 99 99 99 99 99 99 99
