99 99 99 99 99 99 99 99 99 99 99 99 99
99 99 99 99 99 99 99 99 99 99 99 99 99
99 99 99 99 99 99 99 99 99 99 99 99 99
99 99 99 99 99 99 99 99 99 99 99 99 99
99 99 13 99 13 99 13 99 13 99 13 99 99
99 99 13 99 13 99 13 99 13 07 07 99 99
99 99 13 99 13 99 13 99 13 99 13 99 99
99 99 13 99 13 99 13 06 06 06 06 99 99
99 99 13 99 13 99 13 99 13 99 13 99 99
99 99 13 99 13 07 07 07 07 07 07 99 99
99 99 13 99 13 99 13 99 13 99 13 99 99
99 99 13 06 06 06 06 06 06 06 06 99 99
99 99 13 99 13 99 13 99 13 99 13 99 99
99 99 01 01 01 01 01 01 01 01 01 99 99
99 99 12 12 12 12 12 12 12 12 12 99 99
99 99 99 99 99 99 99 99 99 99 99 99 99
99 99 99 99 99 99 99 99 99 99 99 99 99
99 99 99 99 99 99 99 99 99 99 99 99 99
99 99 99 99 99 99 99 99 99 99 99 99 99
99 99 99 99 99 99 99 99 99 99 99 99 99
