99 99 99 99 99 99 99 99 99 99 99 99 99
99 99 99 99 99 99 99 99 99 99 99 99 99
99 99 99 99 99 99 99 99 99 99 99 99 99
99 99 99 99 99 99 99 99 99 99 99 99 99
07 07 07 07 07 13 99 13 07 07 07 07 07
03 03 03 03 03 13 99 13 03 03 03 03 03
13 13 13 13 13 13 99 13 13 13 13 13 13
08 08 08 08 08 13 99 13 08 08 08 08 08
01 01 01 01 01 13 99 13 01 01 01 01 01
07 07 07 07 07 13 99 13 07 07 07 07 07
12 12 12 12 12 13 99 13 12 12 12 12 12
01 01 01 01 01 13 99 13 01 01 01 01 01
08 08 08 08 08 13 99 13 08 08 08 08 08
03 03 03 03 03 13 99 13 03 03 03 03 03
99 99 99 99 99 99 99 99 99 99 99 99 99
99 99 99 99 99 99 99 99 99 99 99 99 99
99 99 99 99 99 99 99 99 99 99 99 99 99
99 99 99 99 99 99 99 99 99 99 99 99 99
99 99 99 99 99 99 99 99 99 99 99 99 99
99 99 99 99 99 99 99 99 99 99 99 99 99
