99 99 99 99 99 99 99 99 99 99 99 99 99
99 99 99 99 99 99 99 99 99 99 99 99 99
99 99 13 99 99 13 99 13 99 99 13 99 99
99 99 13 13 99 99 99 99 99 13 13 99 99
99 99 99 99 99 99 08 99 99 99 99 99 99
99 99 99 99 99 13 03 13 99 99 99 99 99
99 99 99 13 99 99 01 99 99 13 99 99 99
99 99 99 99 99 99 07 99 99 99 99 99 99
99 99 99 13 99 99 06 99 99 13 99 99 99
99 99 99 99 99 13 03 13 99 99 99 99 99
99 99 99 99 99 99 01 99 99 99 99 99 99
99 99 13 13 99 99 99 99 99 13 13 99 99
99 99 13 99 99 13 99 13 99 99 13 99 99
99 99 99 99 99 99 99 99 99 99 99 99 99
99 99 99 99 99 99 99 99 99 99 99 99 99
99 99 99 99 99 99 99 99 99 99 99 99 99
99 99 99 99 99 99 99 99 99 99 99 99 99
99 99 99 99 99 99 99 99 99 99 99 99 99
99 99 99 99 99 99 99 99 99 99 99 99 99
99 99 99 99 99 99 99 99 99 99 99 99 99

