99 99 99 99 99 99 99 99 99 99 99 99 99
99 99 99 99 99 99 99 99 99 99 99 99 99
99 99 99 99 99 99 99 99 99 99 99 99 99
08 99 13 01 01 01 01 01 01 01 13 99 08
08 99 13 13 01 01 01 01 01 13 13 99 08
08 99 13 99 13 01 01 01 13 99 13 99 08
08 99 13 99 99 13 01 13 99 99 13 99 08
08 99 13 99 99 03 12 03 99 99 13 99 08
08 99 13 99 99 03 99 03 99 99 13 99 08
08 99 13 99 99 03 99 03 99 99 13 99 08
08 99 13 99 99 03 99 03 99 99 13 99 08
08 99 13 99 99 03 99 03 99 99 13 99 08
08 99 13 99 99 03 99 03 99 99 13 99 08
08 13 13 13 13 03 99 03 13 13 13 13 08
99 99 99 99 99 99 99 99 99 99 99 99 99
99 99 99 99 99 99 99 99 99 99 99 99 99
99 99 99 99 99 99 99 99 99 99 99 99 99
99 99 99 99 99 99 99 99 99 99 99 99 99
99 99 99 99 99 99 99 99 99 99 99 99 99
99 99 99 99 99 99 99 99 99 99 99 99 99
