99 99 99 99 99 99 99 99 99 99 99 99 99
99 99 99 99 99 99 99 99 99 99 99 99 99
99 99 99 99 99 99 99 99 99 99 99 99 99
99 99 99 99 99 99 99 99 99 99 99 99 99
99 99 99 99 99 99 99 99 99 99 99 99 99
99 99 99 99 99 99 99 99 99 99 99 99 99
99 99 99 99 99 99 99 99 99 99 99 99 99
01 99 99 99 99 99 99 99 99 99 99 99 99
01 02 99 99 99 99 99 99 99 99 99 99 99
01 02 03 99 99 99 99 99 99 99 99 99 99
01 02 03 07 99 99 99 99 99 99 99 99 99
01 02 03 07 10 99 99 99 99 99 99 99 99
01 02 03 07 10 01 99 99 99 99 99 99 99
01 02 03 07 10 01 02 99 99 99 99 99 99
01 02 03 07 10 01 02 03 99 99 99 99 99
01 02 03 07 10 01 02 03 07 99 99 99 99
01 02 03 07 10 01 02 03 07 10 99 99 99
01 02 03 07 10 01 02 03 07 10 01 99 99
01 02 03 07 10 01 02 03 07 10 01 02 99
12 12 12 12 12 12 12 12 12 12 12 12 03
