99 99 99 99 99 99 99 99 99 99 99 99 99
99 99 99 99 99 99 99 99 99 99 99 99 99
99 99 99 99 99 99 99 99 99 99 99 99 99
99 99 99 99 99 99 99 99 99 99 99 99 99
99 99 99 99 99 00 00 00 99 99 99 99 99
99 99 99 99 99 00 00 00 99 99 99 99 99
99 99 99 99 99 00 00 00 99 99 99 99 99
99 99 99 99 00 07 00 07 00 99 99 99 99
99 99 99 99 07 07 07 07 07 99 99 99 99
99 99 99 07 07 07 07 07 07 07 99 99 99
99 99 99 07 07 07 07 07 07 07 99 99 99
99 99 07 07 07 07 07 07 07 07 07 99 99
99 07 07 07 07 07 07 07 07 07 07 07 99
99 99 99 99 99 99 99 99 99 99 99 99 99
99 99 99 99 99 99 99 99 99 99 99 99 99
99 99 99 99 99 99 99 99 99 99 99 99 99
99 99 99 99 99 99 99 99 99 99 99 99 99
99 99 99 99 99 99 99 99 99 99 99 99 99
99 99 99 99 99 99 99 99 99 99 99 99 99
99 99 99 99 99 99 99 99 99 99 99 99 99
