99 99 99 99 99 99 99 99 99 99 99 99 99
99 99 99 99 99 99 99 99 99 99 99 99 99
99 99 99 99 99 99 99 99 99 99 99 99 99
99 99 99 99 99 99 99 99 99 99 99 99 99
02 02 12 12 02 02 02 02 02 12 12 02 02
02 02 12 01 12 02 02 02 12 03 12 02 02
02 02 12 01 01 12 02 12 03 03 12 02 02
02 02 12 01 01 01 12 03 03 03 12 02 02
02 02 12 01 01 01 12 03 03 03 12 02 02
02 02 12 01 01 01 12 03 03 03 12 02 02
02 02 12 01 01 01 12 03 03 03 12 02 02
02 02 12 01 01 01 12 03 03 03 12 02 02
02 02 12 01 01 01 12 03 03 03 12 02 02
02 02 02 12 01 01 12 03 03 12 02 02 02
02 02 02 02 12 01 12 03 12 02 02 02 02
02 02 02 02 02 12 12 12 02 02 02 02 02
99 99 99 99 99 99 99 99 99 99 99 99 99
99 99 99 99 99 99 99 99 99 99 99 99 99
99 99 99 99 99 99 99 99 99 99 99 99 99
99 99 99 99 99 99 99 99 99 99 99 99 99
