99 99 99 99 99 99 99 99 99 99 99 99 99
99 99 99 99 99 99 99 99 99 99 99 99 99
99 99 99 99 99 99 99 99 99 99 99 99 99
99 99 99 99 99 99 99 99 99 99 99 99 99
99 12 12 12 12 12 12 12 12 12 12 12 99
99 12 99 99 99 99 99 99 99 99 99 12 99
99 12 99 12 12 12 12 12 12 12 99 12 99
99 12 99 12 99 99 99 99 99 12 99 12 99
99 12 99 12 99 99 12 99 99 12 99 12 99
99 12 99 12 99 99 99 99 99 12 99 12 99
99 12 99 12 12 12 12 12 12 12 99 12 99
99 12 99 99 99 99 99 99 99 99 99 12 99
99 12 12 12 12 12 12 12 12 12 12 12 99
99 99 99 99 99 99 99 99 99 99 99 99 99
99 99 99 99 99 99 99 99 99 99 99 99 99
99 99 99 99 99 99 99 99 99 99 99 99 99
99 99 99 99 99 99 99 99 99 99 99 99 99
99 99 99 99 99 99 99 99 99 99 99 99 99
99 99 99 99 99 99 99 99 99 99 99 99 99
99 99 99 99 99 99 99 99 99 99 99 99 99
