99 99 99 99 99 99 99 99 99 99 99 99 99
99 99 99 99 99 99 99 99 99 99 99 99 99
99 99 99 99 99 99 99 99 99 99 99 99 99
99 99 99 99 99 99 99 99 99 99 99 99 99
06 06 06 06 06 06 06 06 06 06 06 06 06
03 03 03 03 03 03 03 03 03 03 03 03 03
07 07 07 07 07 07 07 07 07 07 07 07 07
13 13 13 13 13 06 06 06 13 13 13 13 13
13 03 03 03 13 12 12 12 13 03 03 03 13
13 06 06 06 13 99 99 99 13 07 07 07 13
13 99 99 99 99 99 99 99 99 99 99 99 13
13 99 99 99 99 99 99 99 99 99 99 99 13
13 99 99 99 99 99 99 99 99 99 99 99 13
13 99 99 99 13 03 03 03 13 99 99 99 13
13 12 12 12 13 13 13 13 13 12 12 12 13
99 99 99 99 99 99 99 99 99 99 99 99 99
99 99 99 99 99 99 99 99 99 99 99 99 99
99 99 99 99 99 99 99 99 99 99 99 99 99
99 99 99 99 99 99 99 99 99 99 99 99 99
99 99 99 99 99 99 99 99 99 99 99 99 99
