99 99 99 99 99 99 99 99 99 99 99 99 99
99 99 99 99 99 99 99 99 99 99 99 99 99
99 99 99 99 99 99 99 99 99 99 99 99 99
03 13 01 13 02 13 03 13 08 13 01 13 01
08 13 12 13 12 13 12 13 12 13 12 13 02
99 99 08 99 99 99 99 99 99 99 99 99 99
99 13 99 13 08 13 99 13 99 13 99 13 99
99 13 99 13 99 13 08 13 99 13 99 13 99
99 13 99 13 99 13 99 13 08 13 99 13 99
99 99 99 99 99 99 99 99 99 99 99 99 99
99 13 99 13 99 13 08 13 99 13 99 13 99
99 13 99 13 08 13 99 13 99 13 99 13 99
99 99 08 13 99 13 99 13 99 13 99 99 99
08 99 99 99 99 13 99 13 99 99 99 99 99
99 99 99 99 99 99 99 99 99 99 99 99 99
99 99 99 99 99 99 99 99 99 99 99 99 99
99 99 99 99 99 99 99 99 99 99 99 99 99
99 99 99 99 99 99 99 99 99 99 99 99 99
99 99 99 99 99 99 99 99 99 99 99 99 99
99 99 99 99 99 99 99 99 99 99 99 99 99
