99 99 99 99 99 99 99 99 99 99 99 99 99
99 99 99 99 99 99 99 99 99 99 99 99 99
99 99 99 99 99 99 99 99 99 99 99 99 99
07 07 07 07 07 07 07 07 07 07 07 07 07
99 99 99 99 99 99 99 99 99 99 99 99 99
99 12 12 12 99 12 12 12 99 12 12 12 99
99 12 03 12 99 12 03 12 99 12 03 12 99
99 12 12 12 99 12 12 12 99 12 12 12 99
99 99 99 99 99 99 99 99 99 99 99 99 99
99 99 99 12 12 12 99 12 12 12 99 99 99
99 99 99 12 10 12 99 12 10 12 99 99 99
99 99 99 12 12 12 99 12 12 12 99 99 99
99 99 99 99 99 99 99 99 99 99 99 99 99
99 12 12 12 99 12 12 12 99 12 12 12 99
99 12 03 12 99 12 03 12 99 12 03 12 99
99 12 12 12 99 12 12 12 99 12 12 12 99
99 99 99 99 99 99 99 99 99 99 99 99 99
99 99 99 99 99 99 99 99 99 99 99 99 99
99 99 99 99 99 99 99 99 99 99 99 99 99
99 99 99 99 99 99 99 99 99 99 99 99 99
