99 99 99 99 99 99 99 99 99 99 99 99 99
99 99 99 99 99 99 99 99 99 99 99 99 99
99 99 99 99 99 99 99 99 99 99 99 99 99
99 99 99 99 99 99 99 99 99 99 99 99 99
99 99 13 99 13 99 99 99 13 99 13 99 99
99 99 13 03 13 99 99 99 13 03 13 99 99
99 99 13 07 13 99 99 99 13 07 13 99 99
99 99 13 13 13 99 99 99 13 13 13 99 99
99 99 99 99 99 99 99 99 99 99 99 99 99
99 99 99 99 08 07 07 07 01 99 99 99 99
99 99 99 99 08 03 02 03 01 99 99 99 99
99 99 99 99 08 02 03 02 01 99 99 99 99
99 99 99 99 08 03 02 03 01 99 99 99 99
99 99 99 99 08 02 03 02 01 99 99 99 99
99 99 99 99 08 07 07 07 01 99 99 99 99
99 99 99 99 99 99 99 99 99 99 99 99 99
99 99 99 99 99 99 99 99 99 99 99 99 99
99 99 99 99 99 99 99 99 99 99 99 99 99
99 99 99 99 99 99 99 99 99 99 99 99 99
99 99 99 99 99 99 99 99 99 99 99 99 99
