99 99 99 99 99 99 99 99 99 99 99 99 99
99 99 99 99 99 99 99 99 99 99 99 99 99
99 99 99 99 99 99 99 99 99 99 99 99 99
99 99 99 99 99 99 13 99 99 99 99 99 99
99 99 99 99 00 00 99 00 00 99 99 99 99
99 99 00 00 99 99 13 99 99 00 00 99 99
00 00 99 99 01 01 99 01 01 99 99 00 00
99 99 01 01 99 99 13 99 99 01 01 99 99
01 01 99 99 03 03 99 03 03 99 99 01 01
99 99 03 03 99 99 13 99 99 03 03 99 99
03 03 99 99 06 06 99 06 06 99 99 03 03
99 99 06 06 99 99 13 99 99 06 06 99 99
06 06 99 99 07 07 99 07 07 99 99 06 06
99 99 07 07 99 99 13 99 99 07 07 99 99
07 07 99 99 03 03 99 03 03 99 99 07 07
99 99 03 03 99 99 99 99 99 03 03 99 99
03 03 99 99 99 99 99 99 99 99 99 03 03
99 99 99 99 99 99 99 99 99 99 99 99 99
99 99 99 99 99 99 99 99 99 99 99 99 99
99 99 99 99 99 99 99 99 99 99 99 99 99
