99 13 99 99 99 99 99 99 99 99 99 99 99
99 99 99 99 99 99 99 99 99 99 99 99 99
99 13 99 99 99 99 99 99 99 99 99 99 99
99 13 99 99 99 99 99 99 99 99 99 99 99
99 13 99 99 99 99 99 99 99 99 99 99 99
99 13 99 99 99 99 99 07 99 99 99 99 99
99 13 99 99 99 99 07 02 07 99 99 99 99
99 13 99 99 99 07 02 07 02 07 99 99 99
99 13 99 99 07 02 07 12 07 02 07 99 99
99 13 99 99 99 07 02 07 02 07 99 99 99
99 13 99 99 99 99 07 02 07 99 99 99 99
99 13 99 99 99 99 99 07 99 99 99 99 99
99 13 99 99 99 99 99 99 99 99 99 99 99
99 13 99 99 99 99 99 99 99 99 99 99 99
99 13 99 99 99 99 99 99 99 99 99 99 99
99 13 99 99 99 99 99 99 99 99 99 99 99
99 13 13 13 13 13 13 13 13 13 13 13 13
99 99 99 99 99 99 99 99 99 99 99 99 99
99 99 99 99 99 99 99 99 99 99 99 99 99
99 99 99 99 99 99 99 99 99 99 99 99 99

