99 99 99 99 99 99 99 99 99 99 99 99 99
99 99 99 99 99 99 99 99 99 99 99 99 99
99 99 99 99 99 99 99 99 99 99 99 99 99
99 99 99 99 99 99 99 99 99 99 99 99 99
99 99 99 13 13 13 13 13 13 13 99 99 99
99 99 99 03 10 07 13 07 10 03 99 99 99
99 99 99 03 10 07 13 07 10 03 99 99 99
99 99 99 03 10 07 13 07 10 03 99 99 99
99 99 99 03 10 07 13 07 10 03 99 99 99
99 99 99 03 10 07 13 07 10 03 99 99 99
99 99 99 03 10 07 13 07 10 03 99 99 99
99 99 99 03 10 07 13 07 10 03 99 99 99
99 99 99 13 13 13 13 13 13 13 99 99 99
99 99 99 99 99 99 99 99 99 99 99 99 99
99 99 99 99 99 99 99 99 99 99 99 99 99
99 99 99 99 99 99 99 99 99 99 99 99 99
99 99 99 99 99 99 99 99 99 99 99 99 99
99 99 99 99 99 99 99 99 99 99 99 99 99
99 99 99 99 99 99 99 99 99 99 99 99 99
99 99 99 99 99 99 99 99 99 99 99 99 99
