99 99 99 99 99 99 99 99 99 99 99 99 99
99 99 99 99 99 99 99 99 99 99 99 99 99
99 99 99 99 99 99 99 99 99 99 99 99 99
99 99 99 99 99 99 12 99 99 99 99 99 99
99 99 99 99 07 07 12 03 03 99 99 99 99
99 99 99 07 07 00 00 00 03 03 99 99 99
99 99 07 07 00 00 00 00 00 03 03 99 99
99 99 07 07 00 00 00 00 00 03 03 99 99
99 99 07 07 00 00 00 00 00 03 03 99 99
99 99 12 99 12 99 12 99 12 99 12 99 99
99 99 99 99 99 99 12 99 99 99 99 99 99
99 99 99 99 99 99 12 99 99 99 99 99 99
99 99 99 99 13 99 13 99 99 99 99 99 99
99 99 99 99 13 13 13 99 99 99 99 99 99
99 99 99 99 99 13 99 99 99 99 99 99 99
99 99 99 99 99 99 99 99 99 99 99 99 99
99 99 99 99 99 99 99 99 99 99 99 99 99
99 99 99 99 99 99 99 99 99 99 99 99 99
99 99 99 99 99 99 99 99 99 99 99 99 99
99 99 99 99 99 99 99 99 99 99 99 99 99
