99 99 99 99 99 99 99 99 99 99 99 99 99
99 99 99 99 99 99 99 99 99 99 99 99 99
13 13 13 13 13 13 13 13 13 13 13 13 13
99 99 99 99 13 99 99 99 99 99 13 01 99
99 13 03 99 13 99 99 99 99 99 13 99 99
99 13 99 99 13 99 99 13 99 99 13 99 99
99 13 99 99 13 99 99 13 99 99 13 99 99
99 13 99 99 13 03 03 13 99 99 13 99 99
99 13 99 01 13 99 99 13 07 07 13 99 99
99 13 99 99 13 06 06 13 99 99 13 99 99
99 13 99 99 13 99 99 13 99 99 13 99 99
99 13 99 99 13 99 99 13 99 99 13 99 99
99 13 02 99 99 99 99 13 99 99 99 99 99
99 13 99 99 99 99 99 13 99 99 99 99 01
99 13 13 13 13 13 13 13 13 13 13 13 13
99 99 99 99 99 99 99 99 99 99 99 99 99
99 99 99 99 99 99 99 99 99 99 99 99 99
99 99 99 99 99 99 99 99 99 99 99 99 99
99 99 99 99 99 99 99 99 99 99 99 99 99
99 99 99 99 99 99 99 99 99 99 99 99 99
