99 99 99 99 99 99 99 99 99 99 99 99 99
99 99 99 99 99 99 99 99 99 99 99 99 99
99 99 99 99 01 99 99 99 01 99 99 99 99
99 99 99 99 99 01 99 01 99 99 99 99 99
99 99 99 99 99 01 99 01 99 99 99 99 99
99 99 99 99 12 12 12 12 12 99 99 99 99
99 99 99 99 12 12 12 12 12 99 99 99 99
99 99 99 12 12 06 12 06 12 12 99 99 99
99 99 99 12 12 06 12 06 12 12 99 99 99
99 99 12 12 12 12 12 12 12 12 12 99 99
99 99 12 12 12 12 12 12 12 12 12 99 99
99 99 12 99 12 12 12 12 12 99 12 99 99
99 99 12 99 12 99 99 99 12 99 12 99 99
99 99 12 99 12 99 99 99 12 99 12 99 99
99 99 99 99 99 12 99 12 99 99 99 99 99
99 99 99 99 99 12 99 12 99 99 99 99 99
99 99 99 99 99 99 99 99 99 99 99 99 99
99 99 99 99 99 99 99 99 99 99 99 99 99
99 99 99 99 99 99 99 99 99 99 99 99 99
99 99 99 99 99 99 99 99 99 99 99 99 99
