99 99 99 99 99 99 99 99 99 99 99 99 99
99 99 99 99 99 99 99 99 99 99 00 99 99
99 99 99 99 99 99 99 99 99 99 00 00 99
99 99 99 00 00 00 00 99 99 99 99 99 99
99 99 99 99 00 00 00 00 99 99 99 99 99
99 99 99 99 99 13 13 13 99 99 99 99 99
99 99 00 99 99 99 99 99 99 99 99 99 99
99 00 01 00 99 99 99 99 99 99 99 99 99
00 01 13 01 00 99 99 99 99 99 99 99 99
99 00 01 00 99 99 99 99 99 99 99 99 99
99 99 00 99 99 99 99 99 99 99 99 01 01
99 99 08 99 99 13 99 03 03 03 99 99 99
03 99 08 99 03 99 03 99 03 08 03 03 03
13 03 08 03 99 08 03 13 03 99 99 99 99
13 03 08 03 99 03 99 01 03 03 99 99 99
13 13 03 13 03 99 99 03 03 99 99 99 99
99 99 99 99 99 99 99 99 99 99 99 99 99
99 99 99 99 99 99 99 99 99 99 99 99 99
99 99 99 99 99 99 99 99 99 99 99 99 99
99 99 99 99 99 99 99 99 99 99 99 99 99
