99 99 99 99 99 99 99 99 99 99 99 99 99
99 99 99 99 99 99 99 99 99 99 99 99 99
99 99 99 99 99 99 99 99 99 99 99 99 99
99 99 99 99 99 99 99 99 99 99 99 99 99
05 05 05 05 05 05 05 05 05 05 05 05 05
99 99 99 99 99 99 99 99 99 99 99 99 99
00 00 00 13 13 13 13 13 13 13 13 13 13
99 99 99 99 99 99 99 99 99 99 99 99 99
10 10 10 10 10 10 10 10 10 10 10 10 10
99 99 99 99 99 99 99 99 99 99 99 99 99
13 13 13 13 13 13 13 13 13 13 00 00 00
99 99 99 99 99 99 99 99 99 99 99 99 99
08 08 08 08 08 08 08 08 08 08 08 08 08
99 99 99 99 99 99 99 99 99 99 99 99 99
07 07 07 13 13 13 13 13 13 13 13 13 13
99 99 99 99 99 99 99 99 99 99 99 99 99
07 07 07 07 07 07 07 07 07 07 07 07 07
99 99 99 99 99 99 99 99 99 99 99 99 99
13 13 13 13 13 13 13 13 13 13 07 07 07
99 99 99 99 99 99 99 99 99 99 99 99 99
