99 99 99 99 99 99 99 99 99 99 99 99 99
99 99 99 99 99 99 99 99 99 99 99 99 99
99 99 99 99 99 99 99 99 99 99 99 99 99
13 08 08 08 08 08 08 08 08 08 08 08 13
13 99 99 99 99 99 99 99 99 99 99 99 13
13 99 99 99 99 99 99 99 99 99 99 99 13
13 99 99 13 13 13 13 13 13 13 99 99 13
13 99 99 13 07 07 07 07 07 13 99 99 13
13 99 99 13 08 08 08 08 08 13 99 99 13
13 99 99 13 03 03 03 03 03 13 99 99 13
13 99 99 13 09 09 09 09 09 13 99 99 13
13 99 99 13 02 02 02 02 02 13 99 99 13
13 99 99 99 99 99 99 99 99 99 99 99 13
13 99 99 99 99 99 99 99 99 99 99 99 13
13 13 13 13 13 13 13 13 13 13 13 13 13
99 99 99 99 99 99 99 99 99 99 99 99 99
99 99 99 99 99 99 99 99 99 99 99 99 99
99 99 99 99 99 99 99 99 99 99 99 99 99
99 99 99 99 99 99 99 99 99 99 99 99 99
99 99 99 99 99 99 99 99 99 99 99 99 99
