99 99 99 99 99 99 99 99 99 99 99 99 99
99 99 99 99 99 99 99 99 99 99 99 99 99
99 99 99 99 99 99 99 99 99 99 99 99 99
07 07 07 07 07 07 07 07 07 07 07 07 07
07 13 13 13 13 99 13 99 13 13 13 13 07
07 13 99 99 99 99 99 99 99 99 99 13 07
07 13 08 99 99 99 99 99 99 99 08 13 07
07 13 08 08 99 99 99 99 99 08 08 13 07
99 07 13 08 08 99 99 99 08 08 13 07 99
99 99 07 13 08 08 99 08 08 13 07 99 99
99 99 99 07 13 08 08 08 13 07 99 99 99
99 99 99 99 07 13 08 13 07 99 99 99 99
99 99 99 99 99 07 08 07 99 99 99 99 99
99 99 99 99 99 99 07 99 99 99 99 99 99
99 99 99 99 99 99 99 99 99 99 99 99 99
99 99 99 99 99 99 99 99 99 99 99 99 99
99 99 99 99 99 99 99 99 99 99 99 99 99
99 99 99 99 99 99 99 99 99 99 99 99 99
99 99 99 99 99 99 99 99 99 99 99 99 99
99 99 99 99 99 99 99 99 99 99 99 99 99
