99 99 99 99 99 99 99 99 99 99 99 99 99
99 99 99 99 99 99 99 99 99 99 99 99 99
99 99 99 99 99 99 99 99 99 99 99 99 99
99 99 99 99 99 01 02 07 99 99 99 99 99
99 99 99 99 01 03 07 02 01 99 99 99 99
99 99 99 99 02 07 03 01 08 99 99 99 99
99 99 99 03 07 02 01 03 06 08 99 99 99
99 99 99 07 03 01 08 06 03 01 99 99 99
99 99 99 02 01 03 06 08 01 03 99 99 99
99 99 99 01 08 06 03 01 02 07 99 99 99
99 99 99 03 06 08 01 03 07 02 99 99 99
99 99 99 06 03 01 02 07 03 01 99 99 99
99 99 99 99 01 03 07 02 01 99 99 99 99
99 99 99 99 02 07 03 01 08 99 99 99 99
99 99 99 99 99 02 01 03 99 99 99 99 99
99 99 99 99 99 99 99 99 99 99 99 99 99
99 99 99 99 99 99 99 99 99 99 99 99 99
99 99 99 99 99 99 99 99 99 99 99 99 99
99 99 99 99 99 99 99 99 99 99 99 99 99
99 99 99 99 99 99 99 99 99 99 99 99 99
