99 99 99 99 99 99 99 99 99 99 99 99 99
99 99 99 99 99 99 99 99 99 99 99 99 99
99 99 99 99 99 99 99 99 99 99 99 99 99
99 99 99 99 99 99 99 99 99 99 99 99 99
99 10 03 01 12 07 99 03 01 10 03 01 99
99 03 07 12 01 03 99 08 10 03 07 12 99
99 01 12 07 03 01 99 10 03 01 12 07 99
99 12 01 03 08 10 99 03 07 12 01 03 99
99 07 03 01 10 01 99 01 12 07 03 01 99
99 03 08 10 08 03 99 12 01 03 08 10 99
99 01 10 01 03 01 99 07 03 01 10 01 99
99 10 08 03 07 12 99 03 08 10 08 03 99
99 01 03 01 12 07 99 01 10 01 03 01 99
99 03 07 12 01 03 99 10 08 03 07 12 99
99 01 12 07 03 01 99 01 03 01 12 07 99
99 12 01 03 08 10 99 03 07 12 01 03 99
99 07 03 01 10 01 99 01 12 07 03 01 99
99 03 08 10 08 03 99 12 01 03 08 10 99
99 01 10 01 03 07 99 07 03 01 10 01 99
99 10 08 03 01 12 99 03 08 10 08 03 99
