99 99 99 99 99 99 99 99 99 99 99 99 99
99 99 99 99 99 99 99 99 99 99 99 99 99
99 99 99 99 99 99 99 02 02 02 99 99 99
99 99 99 99 99 99 99 02 02 08 99 99 99
99 99 99 99 99 99 02 02 08 08 08 99 99
99 99 99 99 99 99 02 02 02 08 07 99 99
99 99 99 99 99 99 02 02 02 02 07 99 99
99 99 99 99 99 13 02 02 02 02 07 99 99
99 99 99 99 99 01 07 02 02 07 07 99 99
99 99 99 99 99 01 01 07 07 07 99 99 99
99 99 99 99 13 01 13 07 07 07 99 99 99
99 99 99 99 01 01 01 01 99 99 99 99 99
99 99 99 13 01 13 01 99 99 99 99 99 99
99 99 99 01 01 01 01 99 99 99 99 99 99
99 99 99 01 01 01 99 99 99 99 99 99 99
99 99 01 01 01 99 99 99 99 99 99 99 99
99 99 01 01 99 99 99 99 99 99 99 99 99
99 99 99 99 99 99 99 99 99 99 99 99 99
99 99 99 99 99 99 99 99 99 99 99 99 99
99 99 99 99 99 99 99 99 99 99 99 99 99
