99 99 99 99 99 99 99 99 99 99 99 99 99
99 99 99 99 99 99 99 99 99 99 99 99 99
99 99 99 99 99 99 99 99 99 99 99 99 99
99 99 99 99 99 99 99 99 99 99 99 99 99
12 12 12 12 12 12 12 12 12 12 12 12 12
01 01 01 01 01 01 01 01 01 01 01 01 01
12 12 12 12 12 12 12 12 12 12 12 12 12
99 99 99 99 99 99 99 99 99 99 99 99 99
12 12 12 12 12 12 12 12 12 12 12 12 12
06 06 06 06 06 06 06 06 06 06 06 06 06
12 12 12 12 12 12 12 12 12 12 12 12 12
99 99 99 99 99 99 99 99 99 99 99 99 99
99 99 99 99 99 99 99 99 99 99 99 99 99
99 99 99 99 99 99 99 99 99 99 99 99 99
99 99 99 99 99 99 99 99 99 99 99 99 99
99 99 99 99 99 99 99 99 99 99 99 99 99
99 99 99 99 99 99 99 99 99 99 99 99 99
99 99 99 99 99 99 99 99 99 99 99 99 99
99 99 99 99 99 99 99 99 99 99 99 99 99
99 99 99 99 99 99 99 99 99 99 99 99 99
