99 99 99 99 99 99 99 99 99 99 99 99 99
99 99 99 99 99 99 99 99 99 99 99 99 99
99 99 99 99 99 99 99 99 99 99 99 99 99
99 01 01 99 00 00 00 00 00 99 01 01 99
99 00 00 99 01 01 01 01 01 99 00 00 99
99 07 07 99 06 06 06 06 06 99 07 07 99
99 08 08 99 03 03 03 03 03 99 08 08 99
99 03 03 99 07 07 07 07 07 99 03 03 99
99 01 01 99 00 00 00 00 00 99 01 01 99
99 00 00 99 01 01 01 01 01 99 00 00 99
99 99 99 99 99 99 99 99 99 99 99 99 99
99 99 99 99 99 99 99 99 99 99 99 99 99
99 99 99 99 99 99 99 99 99 99 99 99 99
99 99 99 99 99 99 99 99 99 99 99 99 99
99 99 99 99 99 99 99 99 99 99 99 99 99
99 99 99 99 99 99 99 99 99 99 99 99 99
99 99 99 99 99 99 99 99 99 99 99 99 99
99 99 99 99 99 99 99 99 99 99 99 99 99
99 99 99 99 99 99 99 99 99 99 99 99 99
99 99 99 99 99 99 99 99 99 99 99 99 99
