99 99 99 99 99 99 99 99 99 99 99 99 99
99 99 99 99 99 99 99 99 99 99 99 99 99
99 99 99 99 99 99 99 99 99 99 99 99 99
99 99 99 99 99 99 99 99 99 99 99 99 99
10 12 12 12 12 12 12 12 12 12 12 12 10
13 99 99 99 99 99 99 99 99 99 99 99 13
07 07 07 07 07 07 07 07 07 07 07 07 07
99 99 99 99 99 99 99 99 99 99 99 99 99
08 12 12 12 12 12 12 12 12 12 12 12 08
13 99 99 99 99 99 99 99 99 99 99 99 13
07 07 07 07 07 07 07 07 07 07 07 07 07
99 99 99 99 99 99 99 99 99 99 99 99 99
07 12 12 12 12 12 12 12 12 12 12 12 07
13 99 99 99 99 99 99 99 99 99 99 99 13
10 10 10 10 10 10 10 10 10 10 10 10 10
99 99 99 99 99 99 99 99 99 99 99 99 99
10 10 10 10 10 10 10 10 10 10 10 10 10
13 99 99 99 99 99 99 99 99 99 99 99 13
99 99 99 99 99 99 99 99 99 99 99 99 99
99 99 99 99 99 99 99 99 99 99 99 99 99
