99 99 99 99 99 99 99 99 99 99 99 99 99
99 99 99 99 99 99 99 99 99 99 99 99 99
99 99 99 99 99 99 99 99 99 99 99 99 99
99 99 99 99 99 99 99 99 99 99 99 99 99
99 99 13 12 12 13 99 99 99 99 99 99 99
99 13 99 99 99 99 13 99 99 99 99 99 99
13 99 99 02 02 99 99 13 99 99 99 99 99
13 99 07 07 07 07 99 13 99 99 99 99 99
13 99 99 08 08 99 99 13 99 99 99 99 99
99 13 99 99 99 99 13 99 99 99 99 99 99
99 99 13 13 13 13 99 99 99 99 99 99 99
99 99 99 99 99 99 99 99 99 99 99 99 99
99 99 99 99 99 99 99 99 99 99 99 99 99
99 99 99 99 99 99 99 99 99 99 99 99 99
99 99 99 99 99 99 99 99 99 99 99 99 99
99 99 99 99 99 99 99 99 99 99 99 99 99
99 99 99 99 99 99 99 99 99 99 99 99 99
99 99 99 99 99 99 99 99 99 99 99 99 99
99 99 99 99 99 99 99 99 99 99 99 99 99
99 99 99 99 99 99 99 99 99 99 99 99 99
