99 99 99 99 99 99 99 99 99 99 99 99 99
99 99 99 99 99 99 99 99 99 99 99 99 99
07 99 06 99 03 99 08 99 07 99 06 99 08
12 99 12 99 12 99 12 99 12 99 12 99 12
99 03 03 06 99 07 99 01 99 03 99 06 99
99 12 99 12 99 12 99 12 99 12 99 12 99
01 99 07 99 06 99 03 99 08 99 07 99 06
12 99 12 99 12 99 12 99 12 99 12 99 12
99 08 99 03 99 06 99 07 99 01 99 03 99
99 12 99 12 99 12 99 12 99 12 99 12 99
03 99 01 99 07 99 06 99 03 99 08 99 07
12 99 12 99 12 99 12 99 12 99 12 99 12
99 07 99 08 99 03 99 06 99 07 99 01 99
99 12 99 12 99 12 99 12 99 12 99 12 99
06 99 03 99 01 99 07 99 06 99 03 99 08
12 99 12 99 12 99 12 99 12 99 12 99 12
99 99 99 99 99 99 99 99 99 99 99 99 99
99 99 99 99 99 99 99 99 99 99 99 99 99
99 99 99 99 99 99 99 99 99 99 99 99 99
99 99 99 99 99 99 99 99 99 99 99 99 99
