99 99 99 99 99 99 99 99 99 99 99 99 99
99 99 99 99 99 99 99 99 99 99 99 99 99
99 99 99 99 99 99 99 99 99 99 99 99 99
99 99 99 99 99 99 99 99 99 99 99 99 99
99 99 99 99 99 99 99 99 99 99 99 99 99
99 99 99 99 99 99 99 99 99 99 99 99 99
99 07 99 10 99 03 99 03 99 10 99 07 99
99 07 99 10 99 03 99 03 99 10 99 07 99
99 07 99 10 99 03 99 03 99 10 99 07 99
99 07 99 13 08 13 08 13 08 13 99 07 99
99 07 99 10 99 03 99 03 99 10 99 07 99
99 07 99 10 99 03 99 03 99 10 99 07 99
99 07 99 10 99 03 99 03 99 10 99 07 99
99 07 99 10 99 03 99 03 99 10 99 07 99
99 07 99 10 99 03 99 03 99 10 99 07 99
99 07 99 10 99 03 99 03 99 10 99 07 99
99 07 99 10 99 03 99 03 99 10 99 07 99
99 07 99 10 99 03 99 03 99 10 99 07 99
99 08 99 13 99 13 99 13 99 13 99 08 99
99 07 99 10 99 03 99 03 99 10 99 07 99
