99 99 99 99 99 99 99 99 99 99 99 99 99
99 99 99 99 99 99 99 99 99 99 99 99 99
99 99 99 99 99 99 99 99 99 99 99 99 99
99 99 99 99 99 99 99 99 99 99 99 99 99
01 08 99 99 99 99 99 99 99 99 99 99 99
01 08 02 03 99 99 99 99 99 99 99 99 99
01 08 02 03 01 08 99 99 99 99 99 99 99
01 08 02 03 01 08 02 03 99 99 99 99 99
12 08 02 03 01 08 02 03 01 08 99 99 99
99 13 12 03 01 08 02 03 01 08 02 03 99
99 99 99 13 12 08 02 03 01 08 02 03 01
99 99 99 99 99 13 12 03 01 08 02 03 01
99 99 99 99 99 99 99 13 12 08 02 03 01
99 99 99 99 99 99 99 99 99 13 12 03 01
99 99 99 99 99 99 99 99 99 99 99 13 12
99 99 99 99 99 99 99 99 99 99 99 99 99
99 99 99 99 99 99 99 99 99 99 99 99 99
99 99 99 99 99 99 99 99 99 99 99 99 99
99 99 99 99 99 99 99 99 99 99 99 99 99
99 99 99 99 99 99 99 99 99 99 99 99 99
