99 99 99 99 99 99 99 99 99 99 99 99 99
99 99 99 99 99 99 99 99 99 99 99 99 99
99 99 99 99 99 99 99 99 99 99 99 99 99
99 99 99 99 99 06 06 99 99 99 99 99 99
99 99 99 99 06 12 12 06 99 99 99 99 99
99 99 99 99 06 12 06 06 99 99 99 99 99
99 99 99 99 06 06 06 06 99 99 99 99 99
99 99 99 99 06 06 06 06 99 99 99 99 99
99 99 99 99 06 06 06 06 99 99 99 99 99
99 99 99 03 03 06 06 06 07 99 99 99 99
99 99 03 12 12 06 06 12 12 07 99 99 99
99 99 03 12 03 03 07 12 07 07 99 99 99
99 99 03 03 03 03 07 07 07 07 99 99 99
99 99 03 03 03 03 07 07 07 07 99 99 99
99 99 03 03 03 03 07 07 07 07 99 99 99
99 99 03 03 03 03 07 07 07 07 99 99 99
99 99 99 03 03 99 99 07 07 99 99 99 99
99 99 99 99 99 99 99 99 99 99 99 99 99
99 99 99 99 99 99 99 99 99 99 99 99 99
99 99 99 99 99 99 99 99 99 99 99 99 99
